##############################
#............#.......*.......#
#.xxx........#...............#
#.....######..#..#####.#######
#.....#....#..#..#...#.......#
#####.#.##.#..#..#.#...#####.#
#...#.#..#.#..#..#.#........*#
#.#.#.#..#.#..#..#.#####.#####
#.#.#............#.....#.....#
#.#.#####*####..#####.#####..#
#..............#...#.#.......#
#.#####.#####..#.#.#.#.#####.#
#.#....*....#..#.#.#.#...#...#
#.#.#######.#..#.#.#.###.#.###
#.#.#.*...#.#....#...#...#...#
#.#.#.###.#.###.##.#####.###.#
#...#...#.#........#.....#.*.#
#.###.###.#.########.##.##.###
#.#...#...#.#......#.#...#...#
#.#.###.###.#.####.#.#.#.###.#
#.#.#...#...#....#.#.#.#.....#
#.#.#.#*###.##.###.#.#.#####.#
#...#.#.....#..#...#.#...#.*.#
#.#...#.....#..#...#.#.#...#.#
#.#.####.####.###.##.#.###.#.#
#.#...#.......#......#...#...#
#.#.#.#.#######*########.###.#
#...#.#......................#
#...#.#............*.........#
##############################