##############################
#............#...............#
#.xxx........#...............#
#.....######..#..#####.#######
#.....#....#..#..#...#.......#
#####.#.##.#..#..#.#...#####.#
#...#.#..#.#..#..#.#........*#
#.#.#.#..#.#..#..#.#####.#####
#.#.#............#.....#.....#
#.#.#####*####..#####.#####..#
#..............#...#.#.......#
#.###########..#.#.#.#.#####.#
#.#.........#..#.#.#.#...#...#
#.#.#######.#..#.#.#.###.#.###
#.#.#.....#.#....#...#...#...#
#.#.#.###.#.######.#####.###.#
#...#...#.#........#.....#.*.#
#.###.###.#.########.#####.###
#.#...#...#.#......#.#...#...#
#.#.###.###.#.####.#.#.#.###.#
#.#.#...#...#....#.#.#.#.....#
#.#.#.#*###.##.###.#.#.#####.#
#...#.#.....#..#...#.#...#.*.#
#.#...#.....#..#...#.#.#...#.#
#.#.#########.######.#.###.#.#
#.#...#.......#......#...#...#
#.#.#.#.#######*########.###.#
#...#.#......................#
#*..#.#............*.........#
##############################
