##############################
#............*...............#
#...#...#...#...#...#...#....#
#...#...#...#..*#...#...#....#
#............................#
#...#...#...#...#...#...#....#
##.####*####.####.####.####.##
#............................#
#...#...#...#...#...#...#....#
#...#*..#...#...#...#...#....#
#............................#
#...#...#...#...#..*#...#....#
##.####.####.####.####.####.##
#............................#
#...#...#...#...#...#...#.*.##
#.xxx...#...#...#...#...#...##
#............................#
#...#...#..*#...#...#...#....#
##.####.####.####.####.####.##
#............................#
#...#...#...#...#.*.#...#....#
#...#...#...#...#...#...#...##
#............................#
#...#*..#...#...#...#...#....#
##.####.####.####.####.####.##
#............................#
#...#..*#...#...#...#...#...##
#...#...#...#...#...#...#...##
#............................#
##############################