##############################
#*...........................#
#...#...#...#...#...#...#...##
#...#...#...#..*#...#...#...##
#............................#
#...#...#...#...#...#...#...##
##.####*####.####.####.####.##
#............................#
#...#...#...#...#...#...#...##
#...#*..#...#...#...#...#...##
#............................#
#...#...#...#...#..*#...#...##
##.####.####.####.####.####.##
#............................#
#...#...#...#...#...#...#.*.##
#.===...#...#...#...#...#...##
#............................#
#...#...#..*#...#...#...#...##
##.####.####.####.####.####.##
#............................#
#...#...#...#...#.*.#...#...##
#...#...#...#...#...#...#...##
#............................#
#...#*..#...#...#...#...#...##
##.####.####.####.####.####.##
#............................#
#...#..*#...#...#...#...#...##
#...#...#...#...#...#...#...##
#............................#
##############################