##############################
#............................#
#............................#
#.............*..............#
#............................#
#........................*...#
#............................#
#............................#
#............................#
#............................#
#............................#
#xxx.......................* #
#............................#
#............................#
#............................#
#............................#
#.....................*......#
#............................#
#............................#
#............................#
#......*.....................#
#............................#
#............................#
#............................#
#.............*..............#
#............................#
#............................#
#............................#
#..*.......................*.#
##############################