##############################
#xxx.*.......................#
#..#.........................#
#..#######################...#
#........................#...#
#.####################...#...#
#.#..................#...#...#
#.#.##################...#...#
#.#.#....................#...#
#.#.#.####################...#
#.#.#.#....................#.#
#.#.#.#.##################.#.#
#.#.#.#..................#.#.#
#.#.#.##################.#.#.#
#.#.#............*.....#.#.#.#
#.#.##################.#.#.#.#
#.#..................#.#.#.#.#
#.#.##################.#.#.#.#
#.#....................#...#.#
#.#.####################...#.#
#.#............*...........#.#
#.#.########################.#
#.#..........................#
#.#........................* #
#.############################
#............................#
#............................#
#..............*.............#
#............................#
##############################