##############################
#*...........................#
#............................#
#....#####........*..........#
#....#####...................#
#....#####...................#
#............................#
#...............#####........#
#...............#####........#
#*..............#####........#
#............................#
#......xxx...................#
#............................#
#..................*.........#
#............................#
#..####..................#####
#..####.........*........#####
#..####..................#####
#............................#
#............................#
#....#####.........#####.....#
#....#####.........#####.....#
#*...#####....*....#####...* #
#............................#
#............................#
#..#######...............*...#
#............................#
#..........*.................#
#............................#
##############################