##############################
#..........................*.#
#............................#
#............................#
#..########################..#
#........................*#..#
#.........................#..#
#..########################..#
#.......................*....#
#............................#
#............................#
#............................#
#......##################....#
#.......................#*...#
#......................*#....#
#......##################....#
#............................#
#............................#
#............................#
#............................#
#.....###################....#
#...*.#*.....................#
#.....#......................#
#.....###################....#
#............................#
#............................#
#............................#
#.xxx........................#
#............................#
##############################